5
16777215 7
65280 10
8421376 15
16776960 20
16711680 1000

8 7
0 3 3 0 0 0 0
0 4 4 0 4 0 0
0 4 0 0 4 0 0
0 1 1 1 4 0 0
0 4 0 0 4 4 4
0 4 4 0 0 0 0
0 4 0 0 4 0 0
0 2 2 2 4 0 0
